width:27
height:15
100000000000000000010000000
100000000000000000010000000
100000000000000000010000000
100000000000000000010000000
100000000000000000010001100
100000000000000000010001100
100000000000000000010001100
100000000000000000010001100
100000000000000000010001100
100000000000000000010000000
111100000000000000010001100
100000000000000000010000000
100000000000000000010000000
100000000000000000010000000
100000000000000000010000000